xxxxxxxxxxxxxxxxxxxxxxxxxxxxxxx
x___w__________2__________w___x
x__________x__________________x
x__________x__________p_______x
xxxxxx_____x____1_____________x
x____x_____x__________________x
x__w_x__________w_______w_____x
x____x____2________xxxxxxx____x
x____xxxx_____________________x
x_____________________________x
x_________1_x__xxxxx__________x
x___________x______x__________x
x___________x____1_x__________x
xw__________x__w___x_________wx
xxxxxxxxxxxxxexxxxxxxxxxxxxxxxx