xxxxxxxxxxxxxxxxxxxxxxx
x__w__________1_____w_x
x__________x__________e
xxxx_______xxxxxxxxxxxx
x_________2___________x
x_________w___________x
x__1____p_____________x
x_________xxx_________x
x_________x___________x
x_________x_____w_____x
xw________x___________x
xxxxxxxxxxxxxxxxxxxxxxx