xxxxxxxxxexx
x_____w____x
x_____1____x
x__________x
x__________x
x__________x
x__________x
x____p_____x
x__________x
x__w_______x
x__________x
xxxxxxxxxxxx